"Document Name","Start Time",idDocumentSentence1,idDocumentSentence2,"Total Time DS1 (seconds)","Total Time DS2 (seconds)","Time Difference (seconds)","Sentence Text"
Reporter_Brasil_02_13,0,3118633,5229456,0,1900,-1900,"Nos abrigos há uma preocupação muito grande com, não só de receber as pessoas mas como também fazer um trabalho de apoio emocional pra quem, obviamente, perdeu tudo e ainda tem uma preocupação muito grande com o que vem, com o futuro, né, com o que vem aí."
Reporter_Brasil_02_13,14.56,3118635,5229457,0,687,-687,"Eu fui conhecer um trabalho de saúde mental em um dos abrigos, vamos ver como é que foi."
Reporter_Brasil_02_13,20.88,3118637,5229458,2220,596,1624,"Adriano é um dos duzentos desalojados que estão neste abrigo na região metropolitana de Porto Alegre."
Reporter_Brasil_02_13,27.9,5229251,5229467,305,623,-318,"Deficiente visual, ele tem conversado bastante com a psicóloga e confessa que ainda está abalado com tudo que aconteceu."
Reporter_Brasil_02_13,37.11,3118639,5229459,1689,1293,396,"Eles conversam muito comigo, porque a gente não consegue, né, e até mesmo por causa da minha deficiência fica mais difícil, né?"
Reporter_Brasil_02_13,48.6,5229252,5229468,22,91,-69,"Fica mais difícil."
Reporter_Brasil_02_13,50,3118749,5229460,1349,2,1347,"Eliane é voluntária no abrigo e também em uma plataforma online gratuita."
Reporter_Brasil_02_13,55.5,5229253,5229469,178,2,176,"A psicóloga tem procurado alternar o atendimento aos próprios pacientes com a assistência aos desalojados."
Reporter_Brasil_02_13,63.8,5229254,5229470,215,3,212,"Para ela, mais do que fazer perguntas, o momento agora é de ouvir."
Reporter_Brasil_02_13,69.08,3118758,5229461,1109,3,1106,"O acolhimento ele é com um aperto de mão, né, uma troca de olhar sincera, né?"
Reporter_Brasil_02_13,76.5,5229255,5229471,351,6,345,"Formar, dentro da possibilidade, um ambiente em que ele traga."
Reporter_Brasil_02_13,82,5229256,5229472,309,1,308,"A pessoa tem que eleger o que é necessário e o que é importante."
Reporter_Brasil_02_13,84.96,3118760,5229462,765,7,758,"Não é o alimentar e dar um local pra dormir."
Reporter_Brasil_02_13,88.2,5229257,5229473,109,4,105,"É acolher, que é muito mais importante."
Reporter_Brasil_02_13,91,5229258,5229474,300,4,296,"Então a gente vê que essas pessoas são gratas."
Reporter_Brasil_02_13,93.3,5229259,5229475,358,6,352,"Porém, agora, o desafio é voltar para casa."
Reporter_Brasil_02_13,97,5229260,5229476,1140,2,1138,"Eles vão voltar pra uma realidade onde eles vão entrar nos lares e eles vão ter que tirar o lodo."
Reporter_Brasil_02_13,102.1,5229261,5229477,251742,4,251738,"Eles vão perder muitos pertences, e pertences que têm um apelo emocional."
Reporter_Brasil_02_13,106.4,5229249,5229465,5,1,4,"Lembra do Adriano do começo da reportagem?"
Reporter_Brasil_02_13,109,3118762,5229463,77,6,71,"Embora as conversas venham surtindo efeito, pensar no futuro ainda causa desconforto."
Reporter_Brasil_02_13,116.3,5229250,5229466,0,5,-5,"Por enquanto ele só quer um radinho para ouvir as músicas que mais gosta."
Reporter_Brasil_02_13,121.44,3118764,5229464,0,3,-3,"Porto Alegre é longe tô pegando um ônibus pra te encontrar."
Reporter_Brasil_02_14,0,3118766,5229524,16,7,9,"A gente têm visto aqui nessa cobertura, que há solidariedade o tempo inteiro, né? A gente fala isso bastante aqui no jornal, essa solidariedade tomou conta de todo o país em relação ao povo aqui do Rio Grande do Sul e muitas doações têm chegado aqui do Brasil inteiro."
Reporter_Brasil_02_14,4.7,5229262,5229541,0,2,-2,"A gente fala isso bastante aqui no jornal."
Reporter_Brasil_02_14,6.8,5229263,5229542,0,2,-2,"Essa solidariedade tomou conta de todo país em relação ao povo aqui do Rio Grande do Sul."
Reporter_Brasil_02_14,11.7,5229264,5229543,0,4,-4,"E muitas doações têm chegado aqui do Brasil inteiro."
Reporter_Brasil_02_14,15.12,3118768,5229525,0,3,-3,"Mas é preciso observar de que forma esse material tá chegando."
Reporter_Brasil_02_14,19.5,5229265,5229544,0,10,-10,"Tem materiais que têm sido doados, né, e não estão em condiçoes de uso."
Reporter_Brasil_02_14,25.1,5229266,5229545,0,1,-1,"Vamos ver na reportagem."
Reporter_Brasil_02_14,27.4,3118770,5229526,1061,32,1029,"Maria Cristina é voluntária da Ação da Cidadania, organização que está recolhendo doações aqui no Rio de Janeiro para levar ao Rio Grande do Sul e lamenta quando encontra coisas em más condições."
Reporter_Brasil_02_14,39.88,3118772,5229527,3248,14,3234,"Nós estamos pedindo, né, pra quem tem roupas rasgada, suja, sapatos nessas condições, roupa nas condições que estão mandando pra não mandarem, porque lá eles não tem água, estão numa situação precária,. Nós vamos mandar isso?"
Reporter_Brasil_02_14,54.76,3118780,5229528,1416,11,1405,"Na hora de doar, é importante pensar no que enviar, e também no trabalho prévio que muita gente tem que fazer na hora da triagem do que está ou não em bom estado."
Reporter_Brasil_02_14,66.88,3118782,5229529,1104,9,1095,"Não tem água pra lavar roupa, não tem fogão pra cozinhar, não tem, então a gente tem que pensar nisso, parar e pensar, se por no lugar do outro pra você ter sensibilidade de falar: ""Não, peraí, ele merece muito mais, né"""
Reporter_Brasil_02_14,83.52,3118784,5229530,139,3,136,"Há uma diferença muito grande entre descartar e doar."
Reporter_Brasil_02_14,88.84,3118786,5229531,396,3,393,"A doação vêm do coração, do cuidado e escolher aquilo que você vai enviar pra quem precisa."
Reporter_Brasil_02_14,96,3118788,5229532,601,7,594,"E olha só, eu vi agora aqui um exemplo de uma pessoa que doou em saquinhos, tudo cheiroso, dobrado, com até a faixa etária das crianças que vão receber."
Reporter_Brasil_02_14,106.84,3118790,5229533,65,3,62,"Não é pra doar o que você ia jogar fora, né?"
Reporter_Brasil_02_14,108.9,5229267,5229546,165,7,158,"Então você tem que dar uma coisa que esteja em ótimo uso."
Reporter_Brasil_02_14,111.7,5229268,5229547,129,3,126,"Não digo nem em bom uso, é ótimo uso, uma roupa que você estaria usando."
Reporter_Brasil_02_14,115.8,3118792,5229534,2212,6,2206,"É através da solidariedade de quem doa, a gente consegue tá levando alimento, produtos de higiene limpeza e outros itens pra poder dar força, pra poder resgatar essas pessoas, pra que elas consigam tá dando continuidade as suas vidas."
Reporter_Brasil_02_14,134.47,3118794,5229535,5,15,-10,"Bom, PortaNova, Iara, a chuva tinha dado uma parada entre o começo do jornal e até agora, mas voltou a chover forte por aqui e PortaNova, você falou lá no começo do jornal da importância das bombas d&#039;água, a prefeitura anunciou que das vinte e três bombas que existem aqui em Porto Alegre, dez estão em funcionamento."
Reporter_Brasil_02_14,152.72,3118796,5229536,0,3,-3,"Hoje eu fico por aqui, amanhã eu volto com outras informações aqui de Porto Alegre. É com vocês aí em Brasília."
Reporter_Brasil_02_14,157.32,3118798,5229537,0,9,-9,"Tá certo, obrigado. É impressionante que a chuva não para, né? Negócio de louco, não para. Não para de chover."
Reporter_Brasil_02_14,159.32,3118804,5229540,0,0,0,"Brigada, Bárbara."
Reporter_Brasil_02_14,160.72,3118800,5229538,0,3,-3,"Não para, afina e engrossa."
Reporter_Brasil_02_14,162.88,3118802,5229539,0,2,-2,"É, mas continua chovendo, o tempo todo."
Reporter_Brasil_03_11,0.1,3126207,5229297,692,4,688,"Um conjunto de ilhas no litoral da zona oeste do Rio de Janeiro ganhou um importante título internacional pela preservação da biodiversidade."
Reporter_Brasil_03_11,8.84,4358907,5229321,613,6,607,"E são agora reconhecidas como pontos de esperança ou ""hope spots""."
Reporter_Brasil_03_11,14.16,3126209,5229298,48,4,44,"Palmas e peças, as Ilhas da praia de Grumari, além das três ilhas Tijucas, todas localizadas na zona oeste do Rio."
Reporter_Brasil_03_11,21.72,4358909,5229322,195,2,193,"Tiveram o estado de preservação certificado pela Maison Blue, uma organização internacional sem fins lucrativos."
Reporter_Brasil_03_11,28.6,3126211,5229299,298,2,296,"Elas se unem às cagarras na Praia de ipanema para possuirem o título de ""hope sports"", pontos de esperança."
Reporter_Brasil_03_11,35,3126213,5229300,309,0,309,"Os pesquisadores do projeto ""Ihas do Rio"" são os principais responsáveis pelo título, comprovando a biodiversidade das ilhas."
Reporter_Brasil_03_11,42.5,3126215,5229301,297,5,292,"Em apenas oito dias a gente conseguiu levantar mais de duzentas espécies."
Reporter_Brasil_03_11,46.2,4358911,5229323,150,6,144,"E o mais interessante de tudo aqui é que a gente está de frente para um verdadeiro berçário de espécies ameaçadas, né."
Reporter_Brasil_03_11,53.1,3299189,5229312,260,19,241,"Então a gente encontra espécies de garopas, espécies de cavalo-marinho que a gente consegue detectar aqui com a maior facilidade."
Reporter_Brasil_03_11,60.2,3126217,5229302,190,5,185,"As Ilhas de Grumari fazem parte da área protegida no Parque Natural Municipal da Prainha e de Grumari."
Reporter_Brasil_03_11,66.1,3299235,5229313,236,8,228,"A região também tem o selo bandeira azul, renovado anualmente e que certifica a qualidade da água."
Reporter_Brasil_03_11,72.04,4358913,5229324,77,4,73,"Mas a preservação das ilhas não está totalmente livre de ameaças."
Reporter_Brasil_03_11,76.2,3126219,5229303,86,2,84,"Nós já fizemos uma ação de limpeza lá na Ilha de Palmas."
Reporter_Brasil_03_11,78.9,3348655,5229314,422,4,418,"Encontramos muitos resíduos plásticos deixados por visitantes e,  também, lixo encontrado pela maré."
Reporter_Brasil_03_11,86.7,3348657,5229315,225,4,221,"E a gente está buscando uma parceria com os próprios pescadores, associação de moradores, poder público, iniciativa privada para que a gente possa unir forças e cada vez mais preservar esse ambiente."
Reporter_Brasil_03_11,97.1,3126221,5229304,327,10,317,"Outra ameaça são as espécies invasoras, entre elas, o ""Coral-Sol"", conhecido como beleza fatal."
Reporter_Brasil_03_11,104.2,3126223,5229305,93,2,91,"O ""Coral-Sol"", que foi encontrado nessas ilhas, é uma espécie nativa dos oceanos Indico e Pacífico."
Reporter_Brasil_03_11,110,3126225,5229306,58,1,57,"Ele chega principalmente por meio de embarcações."
Reporter_Brasil_03_11,113.4,3348659,5229316,857,9,848,"É uma ameaça à biodiversidade local porque onde cresce, cresce por cima de outras espécies, inibe a passagem de luz e dificulta a fotossíntese."
Reporter_Brasil_03_11,123,3126227,5229307,217,3,214,"O ""Coral-Sol"" ainda se reproduz três vezes mais rápido do que as espécies nativas."
Reporter_Brasil_03_11,128.3,3126229,5229308,886,6,880,"Nós identificamos alguns exemplares, né, algumas poucas colônias do Coral-Sol que pode acabar, né, se multiplicando e se estabilizando nessa área causando os efeitos negativos também para a biodiversidade marinha dessa região."
Reporter_Brasil_03_11,143.5,3126231,5229309,73,2,71,"A presença do Coral-Sol na região é monitorada pelo Instituto Mar Adentro e por universidades."
Reporter_Brasil_03_11,149,3126233,5229310,120,3,117,"Para quem cuida do espaço, a educação ambiental é uma das estratégias para preservar."
Reporter_Brasil_03_11,154.1,3126235,5229311,41,4,37,"A gente só preserva aquilo que a gente conhece."
Reporter_Brasil_03_11,156.6,3348661,5229317,146,4,142,"A gente precisa é de mais educação ambiental e de mais informação."
Reporter_Brasil_03_11,160.6,3348664,5229319,101,6,95,"E que as coisas cheguem com mais facilidade à população."
Reporter_Brasil_03_11,163.6,3348666,5229320,137,12,125,"E  que as pessoas entendam que o que é público tem que ser muito mais cuidado até do que é privado, é nosso isso daqui."
Reporter_Brasil_03_12,0.2,3126237,5229380,172,5,167,"Com um potencial de reciclagem muito alto, o vidro é um dos materiais secos menos recuperados no Brasil."
Reporter_Brasil_03_12,6.48,4358915,5229398,463,3,460,"Ficando atrás de outras categorias como papel, plástico e metal."
Reporter_Brasil_03_12,10,3126239,5229381,42,8,34,"Pois é, agora esse cenário pode mudar, já que o país tem uma entidade que vai gerenciar."
Reporter_Brasil_03_12,14.36,4358917,5229399,121,2,119,"Que deve dar mais eficiência a logística reversa e a economia circular do vidro."
Reporter_Brasil_03_12,20.8,3126241,5229382,154,1,153,"Neste condomínio em Brasília, a separação do lixo já é feita há alguns anos, mas o trabalho de conscientização não é fácil."
Reporter_Brasil_03_12,28,3126243,5229383,71,6,65,"Aqui a gente tem um trabalho constante, pelo menos há três anos."
Reporter_Brasil_03_12,30.96,4358919,5229400,305,12,293,"Sempre tendo que avisar aos moradores, passando, olhando, vendo se eles estão fazendo a separação correta do lixo."
Reporter_Brasil_03_12,36.64,4358921,5229401,167,13,154,"E as vezes dá um trabalho mesmo, porque a gente tem que fazer constantes avisos."
Reporter_Brasil_03_12,45.8,3126245,5229384,273,1,272,"Em alguns casos, o destino do lixo são as cooperativas de catadores."
Reporter_Brasil_03_12,50.5,3126247,5229385,33,8,25,"Chega aqui da forma que está aqui."
Reporter_Brasil_03_12,52,3348674,5229394,400,3,397,"Aí entra  para onde as empilhadeiras estão levando, dali sobe e começa a triagem."
Reporter_Brasil_03_12,57.9,3348678,5229395,179,1,178,"Aí, na esteira, cada material vai para um ""bag"" diferente."
Reporter_Brasil_03_12,62.2,3126251,5229386,168,1,167,"A gente separa papéis, vidros, metais e plásticos."
Reporter_Brasil_03_12,66,3348680,5229396,88,2,86,"No total, dá uns noventa tipos diferentes."
Reporter_Brasil_03_12,68.2,3126253,5229387,173,5,168,"Vai mandar para a indústria, a indústria vai processar e vai fazer a embalagem."
Reporter_Brasil_03_12,72.28,4358923,5229402,159,9,150,"Inclusive, o vidro é um dos produtos que é infinitamente reciclável e uma tonelada de vidro dá uma tonelada de embalagem nova."
Reporter_Brasil_03_12,78.53,4358925,5229403,212,2,210,"Não se perde no processo."
Reporter_Brasil_03_12,82.64,3126255,5229388,72,1,71,"Em 2022, o país instituiu o sistema de logística reversa de embalagens de vidro."
Reporter_Brasil_03_12,88.36,3126257,5229389,148,6,142,"A gente tem hoje, especificamente para o vidro, uma meta que segue o PLANARIS (Plano Nacional de Resíduos Sólidos)."
Reporter_Brasil_03_12,95.3,3348682,5229397,17,9,8,"Então a gente tem hoje, o número que a gente estima é de um pouco mais de vinte e cinco por cento de reciclagem do vidro."
Reporter_Brasil_03_12,104.28,4358927,5229404,6,4,2,"E a nossa meta é que a gente chegue em quarenta por cento até dois mil e trinta e dois."
Reporter_Brasil_03_12,110.2,3126259,5229390,0,7,-7,"A Política Nacional de Resíduos Sólidos de dois mil e dez apontou diretrizes para a melhoria da gestão do lixo:"
Reporter_Brasil_03_12,116.32,4358929,5229405,0,8,-8,"Ela preveu o encerramento dos lixões e o reaproveitamento de cerca de cinquenta por cento dos materiais em vinte anos."
Reporter_Brasil_03_12,123.8,3126261,5229391,0,8,-8,"Uma das formas é a reciclagem, mas hoje apenas cerca de dois por cento dos resíduos das cidades passam por isso."
Reporter_Brasil_03_12,130.8,3126263,5229392,0,2,-2,"Medidas regulatórias, elas tendem a incentivar a reciclagem, né."
Reporter_Brasil_03_12,135.4,3126265,5229393,0,13,-13,"Aqui, nós salvamos o mundo porque a gente cuida de pessoas, a gente cuida da saúde das pessoas,  cuida da saúde do meio ambiente."
Reporter_Brasil_03_12,144.33,4358931,5229406,0,0,0,"E ainda inclui pessoas no processo."
Reporter_Brasil_04_01,0.3,3112121,5229624,4,522,-518,"A gente começa o Repórter Brasil falando sobre os dois anos dos assassinatos do indigenista brasileiro Bruno Pereira e do Jornalista Britânico Don Phillips."
Reporter_Brasil_04_01,11.6,3112123,5229625,0,212,-212,"Eles morreram lutando pela proteção dos povos indígenas que vivem no Vale do Javari, no Amazonas."
Reporter_Brasil_04_01,18.7,3112125,5229626,0,76,-76,"Nós preparamos reportagens especiais que relembram o caso."
Reporter_Brasil_04_01,21.96,4358978,5229658,0,543,-543,"Contam como estão as investigações e dão uma ideia de como estão os defensores dos indígenas que vivem lá na região."
Reporter_Brasil_04_01,29.4,3112127,5229627,0,72,-72,"Hoje o dia foi de homenagens em Brasília."
Reporter_Brasil_04_01,31.7,3112129,5229628,0,225,-225,"Quem acompanhou  e vai trazer os detalhes para a gente agora é a Manuela Castro."
Reporter_Brasil_04_01,35.9,3112131,5229629,0,37,-37,"Manuela, muito boa noite para você."
Reporter_Brasil_04_01,42.28,3112133,5229630,0,119,-119,"Olá, uma ótima noite para você, Porta Nova, para a Iara e para todos que acompanham o Repórter Brasil."
Reporter_Brasil_04_01,48.76,3112135,5229631,0,104,-104,"Eu estou aqui no memorial dos povos indígenas, que fica no centro de Brasília."
Reporter_Brasil_04_01,53.4,4358980,5229659,0,297,-297,"E onde daqui a pouco, está marcado para às sete e meia da noite, vai começar um ato em homenagem aos dois anos de morte de Don Phillips e Bruno Pereira."
Reporter_Brasil_04_01,64,3112137,5229632,282460,175,282285,"Como a gente pode observar, as pessoas já estão aqui trabalhando na organização do evento."
Reporter_Brasil_04_01,67.96,4358982,5229660,165,29,136,"Já tem alguns convidados que já chegaram também."
Reporter_Brasil_04_01,70.68,3112139,5229633,101,13,88,"E, além da homenagem."
Reporter_Brasil_04_01,72.4,4358985,5229662,33873,151,33722,"Ali a gente pode ver uma mesa, em que as pessoas vão debater o que está acontecendo na região onde aconteceram os assassinatos."
Reporter_Brasil_04_01,78.8,3112141,5229634,1978,140,1838,"Também haverá um balanço das ações do governo na terra indígena Vale do Javari."
Reporter_Brasil_04_01,84.21,4358987,5229663,2135,32,2103,"Que fica na região onde aconteceram os assassinatos."
Reporter_Brasil_04_01,87.1,3112143,5229635,1613,339,1274,"Hoje a tarde houve uma roda de conversas e também a exibição de um documentário sobre a morte de Don Phillips e Bruno Pereira."
Reporter_Brasil_04_01,94.24,4358989,5229664,217,7,210,"E também, sobre o que está acontecendo no Vale do Javari."
Reporter_Brasil_04_01,97.32,3112145,5229636,3390,123,3267,"E, agora a noite, começou a projeção das imagens de Don e Bruno na esplanada dos ministérios."
Reporter_Brasil_04_01,105.16,3112147,5229637,815,106,709,"Vamos ver agora uma reportagem que mostra a situação do Vale no Javari."
Reporter_Brasil_04_01,109.96,4358991,5229665,1179,469,710,"Que é a segunda maior terra indígena do Brasil e concentra o maior número de terras indígenas isoladas do mundo."
Reporter_Brasil_04_01,118.36,3112149,5229638,538,18,520,"Vamos ver agora."
Reporter_Brasil_04_01,120.12,3112151,5229639,228,193,35,"O Vale do Javari é uma imensidão de oito milhões de hectares."
Reporter_Brasil_04_01,124.6,4358993,5229666,52,27,25,"Tamanho equivalente a muitos países, como Áustria e Emirados Árabes."
Reporter_Brasil_04_01,128.6,3112153,5229640,0,39,-39,"Fica na fronteira entre Brasil, Peru e Colômbia."
Reporter_Brasil_04_01,131.96,3112155,5229641,0,122,-122,"Os povos que vivem ali reclamam da insegurança e da falta de agentes públicos."
Reporter_Brasil_04_01,136.6,3112157,5229642,0,10,-10,"Permanente aqui, nessa região, não tem não, mas para fazer um trabalho esporádico, vai lá fazer uma operação rápida e volta."
Reporter_Brasil_04_01,144.83,4358996,5229668,0,1,-1,"O Exército faz, o IBAMA as vezes faz também, fez uma vez com a FUNAI e… só se for ação pontual mesmo."
Reporter_Brasil_04_01,154.84,3112159,5229643,0,1,-1,"Agora, permanente, efetivamente, nessa região não tem como não."
Reporter_Brasil_04_01,159.6,3112161,5229644,0,8,-8,"De acordo com a união dos povos indígenas do Vale do Javari, na época dos assassinatos de Bruno e Don em dois mil e vinte e dois, onze pessoas eram ameaçadas de morte na região."
Reporter_Brasil_04_01,169.48,3112163,5229645,0,3,-3,"A gente fica o tempo todo extremamente preocupado sobre o risco de um caso parecido voltar a se repetir."
Reporter_Brasil_04_01,175.32,4358998,5229669,0,1,-1,"Porque tem pessoas muito engajadas na luta pelo Vale do Javari, que seguem sofrendo ameaças."
Reporter_Brasil_04_01,182.1,3112165,5229646,0,5,-5,"Então, acho que esse é um ponto muito sério, que teve um pequeno avanço de colocá-los no programa."
Reporter_Brasil_04_01,186.44,4359000,5229670,0,1,-1,"Mas que o programa ainda não ofereceu medidas concretas de proteção como essas pessoas precisam."
Reporter_Brasil_04_01,192.6,3112167,5229647,0,2,-2,"O Governo lançou um plano de proteção do Vale do Javari."
Reporter_Brasil_04_01,195.9,3348733,5229656,1894,4,1890,"Entre as ações está o programa para proteger os defensores dos Direitos Humanos."
Reporter_Brasil_04_01,200.64,4359002,5229671,993,1,992,"Que tem uma equipe de oito profissionais de diversas áreas."
Reporter_Brasil_04_01,204.04,3112171,5229648,2821,4,2817,"Hoje nós já contamos naquele território com uma estrutura que garante a rápida comunicação com Brasília, a rápida comunicação com a equipe técnica federal."
Reporter_Brasil_04_01,214.44,4359004,5229672,423,0,423,"Dessas equipes que estão lá e, também, com outros órgãos de Governo."
Reporter_Brasil_04_01,218.5,3348735,5229657,3516,2,3514,"Então, com a FUNAI, com os povos indígenas,  com a própria Polícia Federal."
Reporter_Brasil_04_01,222.36,4359006,5229673,1406,4,1402,"Essa equipe, ela está habilitada a fazer esses diálogos buscando a garantia da proteção das lideranças."
Reporter_Brasil_04_01,228.2,3112173,5229649,1507,2,1505,"A viúva de Bruno Pereira não espera apenas justiça, mas também quer segurança para as comunidades amazônicas."
Reporter_Brasil_04_01,234.8,3112175,5229650,1034,1,1033,"Para além da punição dos executores, a gente espera que seja feito realmente um trabalho de desmantelamento daquela cadeia criminosa."
Reporter_Brasil_04_01,243.5,4359008,5229674,193,0,193,"Que se não for tratado isso, vai vitimar outras pessoas, né?"
Reporter_Brasil_04_01,248.68,3112177,5229651,15,0,15,"E, sobretudo, as lideranças indígenas."
Reporter_Brasil_04_01,251.2,3112179,5229652,270,2,268,"Segundo a Polícia Federal, há um plano de segurança para a região."
Reporter_Brasil_04_01,255.44,3112181,5229653,640,3,637,"Já no início do ano passado, nós deslocamos uma base fluvial, que é a base Nova Era, para a região do Vale do Javari."
Reporter_Brasil_04_01,265.84,4359010,5229675,24,1,23,"Implementamos novas ações, ações essas, inclusive, integradas com outros órgãos."
Reporter_Brasil_04_01,272.1,3112183,5229654,818,2,816,"A gente espera que melhore as ações do Governo, sobretudo a proteção territorial, a segurança, saúde, educação."
Reporter_Brasil_04_01,287.7,3112185,5229655,387,1,386,"Esses três, quatro temas principais que a gente espera que o Governo faça suas responsabilidades e ações, né?"
Reporter_Brasil_04_03,0.1,3350609,5229763,1661,1,1660,"Cheias, secas, tragédias climáticas que se espalham pelo mundo."
Reporter_Brasil_04_03,3.8,3350611,5229764,2708,2,2706,"Para frear a degradação de nossa terra, as Nações Unidas criaram o dia mundial do Meio Ambiente, que celebra hoje, cinco de junho."
Reporter_Brasil_04_03,11.1,3350613,5229765,0,1,-1,"Lideranças mundiais em diferentes campos estão reunidas nessa semana toda para encontrar soluções para a restauração do planeta."
Reporter_Brasil_04_03,19.3,3350617,5229766,0,4,-4,"Todos os anos, autoridades dos Estados e entidades das sociedades civis, reúnem-se para discutir as emergências ligadas as mudanças climáticas."
Reporter_Brasil_04_03,27.8,3350619,5229767,0,1,-1,"Em dois mil e vinte e quatro, a reunião acontece na Arábia Saudita."
Reporter_Brasil_04_03,31.16,4359059,5229797,0,0,0,"E o foco é o problema da desertificação, a restauração de terras e a resiliência à seca."
Reporter_Brasil_04_03,36.8,3350625,5229768,0,3,-3,"Mas os efeitos das mudanças climáticas estão em toda a parte."
Reporter_Brasil_04_03,40.2,3350629,5229769,0,5,-5,"No sul do Brasil, a enchente afetou quase noventa e cinco por cento do Rio Grande do Sul."
Reporter_Brasil_04_03,44.88,4359043,5229789,0,1,-1,"De acordo com o relatório da Defesa Civil gaúcha."
Reporter_Brasil_04_03,47.6,3350631,5229770,0,2,-2,"Ao todo,  quatrocentos e setenta e seis municípios foram atingidos."
Reporter_Brasil_04_03,52.1,3350633,5229771,0,1,-1,"Nos últimos cinco anos, a gente viu o aumento de frequência e intensidade de enventos climáticos importantes."
Reporter_Brasil_04_03,60.2,3350635,5229772,0,1,-1,"O último deles, infelizmente, a catástrofe que a gente viu no Rio Grande do Sul."
Reporter_Brasil_04_03,64.55,4359045,5229790,0,1,-1,"Mas, além disso, a gente tem visto frequência de intensidade de eventos."
Reporter_Brasil_04_03,69.71,4359047,5229791,0,1,-1,"Por exemplo, no próprio sul nos últimos anos que também fizeram perder vidas."
Reporter_Brasil_04_03,74.1,3350637,5229773,0,1,-1,"Seca no Pantanal."
Reporter_Brasil_04_03,75.32,4359049,5229792,0,6,-6,"O período de estiagem começou no mês passado e o alerta do serviço geológico é de seca severa nos próximos meses na bacia do rio Paraguai."
Reporter_Brasil_04_03,84,3350639,5229774,0,1,-1,"Os impactos são locais, regionais e internacionais."
Reporter_Brasil_04_03,87.24,4359051,5229793,0,2,-2,"Na fauna, na flora, nas comunidades ribeirinhas, limitação a navegação, risco de incêndios florestais."
Reporter_Brasil_04_03,94,3350641,5229775,0,2,-2,"O relatório anual  de desmatamento publicado pela rede  ""Mapa e biomas"" revela que o Cerrado já é o  bioma mais devastado no Brasil."
Reporter_Brasil_04_03,102,3350643,5229776,0,1,-1,"É no Cerrado que ocorre sessenta e um por cento do desmatamento total."
Reporter_Brasil_04_03,106.4,3350647,5229777,0,0,0,"Maranhão foi o estado onde mais se desmatou no ano passado."
Reporter_Brasil_04_03,109.5,3350650,5229779,0,1,-1,"O Brasil perdeu mais de um milhão de hectares de Cerrado só em dois mil e vinte e três."
Reporter_Brasil_04_03,114.2,3350652,5229780,0,2,-2,"Isso equivale a sete vezes o tamanho da cidade de São Paulo."
Reporter_Brasil_04_03,117.9,3350654,5229781,0,2,-2,"A  devastação da Amazônia não deixa de ser preocupante."
Reporter_Brasil_04_03,121.1,3350656,5229782,0,2,-2,"Há dois anos, a fumaça das queimadas no norte do país cobriu cinco milhões de quilômetros em território brasileiro."
Reporter_Brasil_04_03,127.64,4359053,5229794,0,0,0,"Atingindo São Paulo, Paraná e até a Bolívia."
Reporter_Brasil_04_03,130.9,3350658,5229783,0,1,-1,"As mudanças climáticas são reais e elas demandam políticas de resiliência para as cidades e regiões que podem ser mais afetadas."
Reporter_Brasil_04_03,139.2,3350660,5229784,0,1,-1,"Chuvas fortes vão acontecer de novo; famílias vão perder suas casas e muitos vão se mobilizar em solidariedade."
Reporter_Brasil_04_03,147.47,4359055,5229795,0,3,-3,"Só que muitas dessas perdas também podem ser evitadas."
Reporter_Brasil_04_03,151,3350662,5229785,0,2,-2,"O conceito de resiliência, ou também o conceito de adaptação, é justamente se preparar, é não esperar o evento acontecer."
Reporter_Brasil_04_03,157.8,3350664,5229786,0,5,-5,"Além da resiliência e da prevenção a catástrofes, enfrentar as mudanças climáticas envolve observar o Código Florestal Brasileiro."
Reporter_Brasil_04_03,165.64,4359057,5229796,0,2,-2,"Uma das leias de proteção mais avançadas no mundo para preservar e, também, obras de adaptação à nova realidade."
Reporter_Brasil_04_03,172.7,3350666,5229787,0,5,-5,"Dá para fazer mudanças de gestão, mudança até de localização física, se for necessário, como foi a criação de Brasília."
Reporter_Brasil_04_03,179.5,3350668,5229788,0,1,-1,"A gente tem coisas para se adaptar e pode fazer coisas interessantes e se valer do grande território que a gente tem."
Reporter_Brasil_04_06,0,4344395,5229851,245,318,-73,"A produção industrial nacional caiu meio por cento em abril."
Reporter_Brasil_04_06,3.55,3113811,5229843,1283,158,1125,"Houve queda significativa nas produções de minério de ferro e de petróleo no mês."
Reporter_Brasil_04_06,9.27,3113813,5229844,2330,547,1783,"Os dados do IBGE divulgados hoje mostram que a produção industrial caiu em Abril depois de dois meses seguidos de alta."
Reporter_Brasil_04_06,17.57,3113815,5229845,231,347,-116,"Dessa vez,  o setor extrativista pesou negativamente, com queda de três vírgula quatro por cento no mês."
Reporter_Brasil_04_06,24.8,3113817,5229846,827,266,561,"Dentro desses seguimentos estão grandes empresas, como a Vale e a Petrobrás, que têm  o minério e o petróleo como matéria-prima."
Reporter_Brasil_04_06,31.88,3113819,5229847,1236,400,836,"Já produtos de maior valor agregado, apresentaram alta na produção como máquinas e equipamentos usados em indústrias."
Reporter_Brasil_04_06,39.3,3113821,5229848,6,83,-77,"A produção de carros e caminhões foi a que mais cresceu em Abril, com alta de mais de treze por cento."
Reporter_Brasil_04_06,45.6,3113823,5229849,9,117,-108,"Apesar da queda recente, a produção industrial no Brasil ainda sobe três e meio por cento neste ano."
Reporter_Brasil_04_06,52.3,3113825,5229850,10487,140,10347,"Em comparação com o mesmo período do ano passado."
Reporter_Brasil_05_01,0.1,3111662,5229878,4119,1,4118,"Quarenta e duas escolas e quatro postos de saúde não abriram as portas hoje no Rio de Janeiro."
Reporter_Brasil_05_01,5.92,4361528,5229890,1361,1,1360,"Por causa de tiroteios durante uma ação policial no Complexo da Maré."
Reporter_Brasil_05_01,10.4,3111664,5229879,641,1,640,"Um policial e dois suspeitos foram mortos."
Reporter_Brasil_05_01,15.28,3111667,5229881,1498,2,1496,"De acordo com a PM, os confrontos entre policiais e criminosos no Complexo da Maré, na Zona Norte do Rio, deixaram um policial morto e outro ferido."
Reporter_Brasil_05_01,24.2,3111669,5229882,13335,1,13334,"Outros dois homens suspeitos de serem seguranças do tráfico morreram."
Reporter_Brasil_05_01,28.04,3111671,5229883,462,0,462,"Os tiroteios aconteceram no início da manhã de hoje."
Reporter_Brasil_05_01,31.56,4361530,5229891,1804,3,1801,"Devido a uma operação para apreender suspeitos de roubos de veículos em vias expressas da cidade."
Reporter_Brasil_05_01,37.2,3111673,5229884,471,1,470,"Próximo a um conjunto de favelas da Maré, um ônibus foi incendiado na Avenida Brasil."
Reporter_Brasil_05_01,41.92,4361532,5229892,1020,1,1019,"Uma das principais vias de acesso ao centro do Rio, e o trânsito foi interrompido."
Reporter_Brasil_05_01,47.1,3111677,5229885,1219,2,1217,"As linhas amarela e vermelha, que dão acesso ao aeroporto internacional do Rio de Janeiro, também ficaram bloqueadas."
Reporter_Brasil_05_01,54.2,3111679,5229886,738,3,735,"Os veículos só voltaram a circular no fim da manhã."
Reporter_Brasil_05_01,57.6,3111681,5229887,5332,2,5330,"Segundo os governos municipal e estadual, quarenta escolas do município e duas do estado não abriram as portas por causa dos tiroteios."
Reporter_Brasil_05_01,66.2,3111683,5229888,772,1,771,"Quatro postos de saúde também tiveram os atendimentos interrompidos."
Reporter_Brasil_05_01,70.48,3111685,5229889,1555,1,1554,"A PM disse que prendeu dois suspeitos e recuperou quatro veículos roubados, além de apreender armas e material usado para embalar entorpecentes."
Reporter_Brasil_05_02,0.1,3111693,5229935,2472,4,2468,"A Procuradoria Federal dos Direitos do Cidadão do Ministério Público Federal enviou ao Procurador Geral da República, Paulo Gonet, um parecer que considera inconstitucional a lei aprovada no Estado de São Paulo, que criou o programa de escolas cívico-militares."
Reporter_Brasil_05_02,18.6,3111695,5229936,331,1,330,"O PSOL já havia entrado com uma ação no Supremo Tribunal Federal."
Reporter_Brasil_05_02,22.44,4361534,5229953,1461,1,1460,"Exatamente contra o projeto que tem enfrentado críticas de especialistas em educação."
Reporter_Brasil_05_02,29,3111697,5229937,2589,5,2584,"Por meio do programa Escola Cívico-Militar, a secretaria da segurança pública vai indicar policiais militares da reserva para atuar como monitores."
Reporter_Brasil_05_02,37.9,3112376,5229938,6256,5,6251,"Além de desenvolver atividades extracurriculares e organizar a disciplina e a segurança nas escolas da rede pública estadual de São Paulo."
Reporter_Brasil_05_02,46.44,3112378,5229939,810,2,808,"A lei sancionada no fim de maio foi considerada inconstitucional pela Procuradoria Federal dos Direitos do Cidadão."
Reporter_Brasil_05_02,53.32,4361536,5229954,1126,1,1125,"Que faz parte do Ministério Público Federal."
Reporter_Brasil_05_02,56.28,3112380,5229940,1519,3,1516,"Na decisão, o Ministério Público aponta a falta de evidências científicas ou estudos conclusivos."
Reporter_Brasil_05_02,62,4361538,5229955,1316,1,1315,"Que atestem a melhora no comportamento dos alunos e a qualidade do ensino."
Reporter_Brasil_05_02,66.96,3112382,5229941,685,1,684,"No ano passado fizemos uma pesquisa com o Instituto Data Folha."
Reporter_Brasil_05_02,69.88,4361540,5229956,2678,4,2674,"Mostrava que setenta e três por cento da população confia mais em professores do que em militares para trabalharem nas escolas."
Reporter_Brasil_05_02,79.04,4361542,5229957,921,1,920,"E essa mesma pesquisa também perguntou quais são as prioridades que as pessoas teriam nas escolas."
Reporter_Brasil_05_02,84.16,3112384,5229942,1486,1,1485,"A primeira prioridade é infraestrutura, a segunda é a valorização do magistério, a terceira é formação dos professores e professoras."
Reporter_Brasil_05_02,92.8,3112386,5229943,332,0,332,"A questão da violência nas escolas apareceu como a quinta questão pela população."
Reporter_Brasil_05_02,97.9,3112388,5229944,449,1,448,"Então, o que as pessoas querem é uma escola de maior qualidade."
Reporter_Brasil_05_02,100.7,3112390,5229945,441,1,440,"Para esta pesquisadora da UNB, a falta de segurança nas escolas reflete a falta de segurança na sociedade."
Reporter_Brasil_05_02,107.44,4361544,5229958,978,0,978,"E a presença de militares no ambiente escolar não é a solução."
Reporter_Brasil_05_02,112,3112392,5229946,309,1,308,"Quem é que são os profissionais responsáveis pela segurança?"
Reporter_Brasil_05_02,115.84,3112394,5229947,1565,1,1564,"São exatamente esses profissionais da área de segurança e que não estão resolvendo a questão da violência fora da escola."
Reporter_Brasil_05_02,123.52,4361546,5229959,758,1,757,"E o que eles vão poder fazer plantados dentro da escola?"
Reporter_Brasil_05_02,126.9,3112396,5229948,1455,1,1454,"Então, se a gente quer escolas sem violência, a gente precisa construir uma sociedade em que a violência não esteja presente."
Reporter_Brasil_05_02,134.9,3112398,5229949,2720,2,2718,"A área militar é o espaço do não questionamento, da obediência, né, sem que nada seja questionado."
Reporter_Brasil_05_02,141.84,3112400,5229950,906,1,905,"Então, militarizar escola é negar a possibilidade de que essa escola seja um espaço de diálogo."
Reporter_Brasil_05_02,148.08,4361548,5229960,683,1,682,"Em que os diversos e os diferentes podem conviver inclusive a partir de perspectivas e ideias diferentes."
Reporter_Brasil_05_02,156.28,3112402,5229951,2156,1,2155,"A Secretaria de Educação informou que o projeto, lá de São Paulo, né, a Secretaria, o projeto foi elaborado a partir de proposições de grupos de trabalho e estudos técnicos conjuntos das Secretarias de Estado da Educação e da Segurança Pública."
Reporter_Brasil_05_02,169.64,4361550,5229961,25,1,24,"Seguindo os Princípios da Lei de Diretrizes e Bases dos Planos Nacional e Estadual de Educação."
Reporter_Brasil_05_02,175.48,3112404,5229952,918,5,913,"E que reforçou que o modelo não será imposto, cada implantação passará por consulta pública."
Reporter_Brasil_05_03,0.28,3112660,5230009,1970,5,1965,"A professora de uma escola municipal no Rio de Janeiro foi presa após atacar uma das alunas com ofensas racistas."
Reporter_Brasil_05_03,8.6,3112662,5230010,1644,1,1643,"Pois é, a família chamou a polícia e luta agora por justiça para que casos como esse não voltem a acontecer."
Reporter_Brasil_05_03,17.52,3112664,5230011,67,3,64,"A professora Cristiane Bispo Valeriano, que da aula na escola municipal Estados Unidos, localizada no Rio de Janeiro, foi levada pela ambulância do Corpo de Bombeiros."
Reporter_Brasil_05_03,28.7,3112666,5230012,0,6,-6,"Ela passou mal ao ser presa em flagrante pelo crime de injúria racial."
Reporter_Brasil_05_03,33.96,3112668,5230013,0,0,0,"A vítima, uma menina de oito anos."
Reporter_Brasil_05_03,36.9,3349207,5230025,0,0,0,"A mãe relata que aconteceu."
Reporter_Brasil_05_03,38.92,3112670,5230014,0,2,-2,"Na quarta-feira passada, a minha filha chegou em casa falando que a professora tinha chamado ela de lixo, que ela fumava craque e tacou uma bolinha de papel nela."
Reporter_Brasil_05_03,48.4,3112672,5230015,0,4,-4,"Chegou na sexta-feira, a professora chamou ela de preta do cabelo duro."
Reporter_Brasil_05_03,53,3112674,5230016,0,2,-2,"E falou que ela morava debaixo da ponte ainda, né."
Reporter_Brasil_05_03,55.8,3112676,5230017,0,1,-1,"E aí, na sexta-feira, na mesma hora que minha filha me ligou, eu vim aqui com a polícia."
Reporter_Brasil_05_03,61.4,3112678,5230018,0,0,0,"A Secretaria Municipal de Educação do Rio de Janeiro informou que instaurou sindicância para apurar o caso."
Reporter_Brasil_05_03,67.92,4361554,5230026,0,1,-1,"E que a professora foi afastada de suas funções e pode ser demitida do serviço público."
Reporter_Brasil_05_03,73.44,3112680,5230019,0,4,-4,"Enquanto isso, já surgiram outros relatos semelhantes de injúria racial envolvendo a mesma professora."
Reporter_Brasil_05_03,80.9,3112682,5230020,0,5,-5,"Começou a chegar áudios pra mim, no WhatsApp, de pessoas que estudaram com ela anos atrás e que falou que sofreu a mesma coisa com ela, racismo."
Reporter_Brasil_05_03,91.12,3112684,5230021,0,1,-1,"A pena para o crime de injúria racial é de reclusão de dois a cinco anos, além de multa."
Reporter_Brasil_05_03,97.3,3112686,5230022,0,2,-2,"Esse pesquisador fala sobre as mudanças necessárias para construirmos uma sociedade anti-racista."
Reporter_Brasil_05_03,104.28,3112688,5230023,0,1,-1,"Essa interpretação da lei e a lei, ela precisa ser mudada para que isso seja incluso."
Reporter_Brasil_05_03,110.44,4361556,5230027,0,1,-1,"Para que essa questão da injúria racial seja considerada como racismo de fato."
Reporter_Brasil_05_03,115.44,4361558,5230028,0,1,-1,"E que as pessoas passem a ser responsabilizadas por racismo e pagar por isso, só assim o racismo pode começar a ser minimizado na sociedade."
Reporter_Brasil_05_03,132.76,3112690,5230024,0,1,-1,"Nossa produção tentou entrar em contato com a defesa da professora Cristiane Bispo Valeriano, mas não obteve resposta."
Reporter_Brasil_07_02,0,3117268,5230071,137,211,-74,"E agora, quais as repercussões dessas decisões do STF?"
Reporter_Brasil_07_02,3.56,3117270,5230072,592,381,211,"Segundo especialistas, uma das expectativas é diminuir injustiças contra negros e pobres nas periferias."
Reporter_Brasil_07_02,10.52,4372930,5230089,533,944,-411,"Além de impactar o crime organizado e diminuir o chamado encarceramento em massa no país."
Reporter_Brasil_07_02,17.08,3117272,5230073,835,1337,-502,"Pela decisão do Supremo, agora, quem for enquadrado pela polícia como usuário não será fichado com antecedentes criminais, mas estará sujeito a penas administrativas e socioeducativas."
Reporter_Brasil_07_02,30.04,4372932,5230090,291,262,29,"Como participar de cursos sobre dependência."
Reporter_Brasil_07_02,33.24,3117274,5230074,721,527,194,"Além disso, continua sendo proibido usar maconha em lugares públicos."
Reporter_Brasil_07_02,38.28,3117276,5230075,871,1302,-431,"A gente tem uma consciência social, ninguém quer causar transtorno para vizinho, não dar trabalho para ninguém."
Reporter_Brasil_07_02,46.04,3117280,5230076,379,214,165,"Eu acho que as pessoas não queriam se sentir criminosas."
Reporter_Brasil_07_02,48.52,3117284,5230077,729,4379,-3650,"Todo cenário é de muita cautela, muito respeito, até porque tem que lembrar que a cannabis ainda é uma substância proibida, não foi legalizada."
Reporter_Brasil_07_02,56.84,3117286,5230078,1723,5,1718,"Do ponto de vista das contas públicas, hoje, o Brasil gasta quase seiscentos milhões de reais por ano para manter na cadeia cerca de dezenove mil presos condenados por portar até cem gramas de maconha."
Reporter_Brasil_07_02,72.04,3117290,5230079,954,2,952,"Quando a quantidade é reduzida para até vinte e cinco gramas, o número de presos cai para menos de nove mil."
Reporter_Brasil_07_02,78.84,4372936,5230091,203,1,202,"Com gastos estimados de duzentos e sessenta e três milhões de reais."
Reporter_Brasil_07_02,83.64,3117292,5230080,1049,1,1048,"Você tira uma discussão que deixa só a cargo do delegado, do juiz ou do judiciário como um todo, decidir quem vai ou quem não vai para a cadeia."
Reporter_Brasil_07_02,93.6,4372938,5230092,916,2,914,"Tirando essa questão que às vezes injustamente acontecia de se for pego em uma situação de vulnerabilidade, em um local mais humilde, de fato era colocado no sistema prisional."
Reporter_Brasil_07_02,104.44,3117294,5230081,309,2,307,"A decisão do Supremo é definitiva e deve começar a valer assim que for publicada."
Reporter_Brasil_07_02,109.6,3117296,5230082,914,1,913,"Mas o Congresso continua analisando uma mudança na constituição, que pode reverter a situação."
Reporter_Brasil_07_02,115.68,3117298,5230083,2512,1,2511,"A PEC, que já foi aprovada no senado e agora será discutida em uma comissão especial na câmara, torna crime o porte e a posse de todas as drogas em qualquer quantidade."
Reporter_Brasil_07_02,126.64,3117300,5230084,1154,3,1151,"Além disso, a decisão do Supremo foi interpretada por alguns parlamentares, incluindo o presidente do senado Rodrigo Pacheco, como invasão de competência legislativa."
Reporter_Brasil_07_02,137.32,3117302,5230085,740,1,739,"No início da sessão de hoje do Supremo, o presidente da corte falou sobre as acusações de que o STF invadiu a competência do congresso sobre o tema."
Reporter_Brasil_07_02,147.4,3117304,5230086,305,2,303,"Quem recebe os habeas corpus, que envolve as pessoas presas com drogas, é o Supremo Tribunal Federal."
Reporter_Brasil_07_02,158.84,3117306,5230087,1195,2,1193,"E, portanto, nós precisamos ter um critério que oriente a nós mesmos em que situações se deve considerar tráfico e em que situação se deve considerar uso."
Reporter_Brasil_07_02,171,3117308,5230088,0,1,-1,"Portanto, não existe matéria mais pertinente à atuação do Supremo do que essa."
Reporter_Brasil_07_03,0,3258538,5230128,850,1,849,"Para evitar o uso de drogas entre crianças e adolescentes, o Ministério da Justiça lançou um programa com foco no ambiente escolar."
Reporter_Brasil_07_03,8.92,3258542,5230129,580,3,577,"O Cria Prevenção e Cidadania vai ser implantado em municípios de três estados, mas a meta é se espalhar pelo resto do Brasil até dois mil e vinte e seis."
Reporter_Brasil_07_03,19.52,3258546,5230130,696,2,694,"Prevenção é a palavra chave do programa contra uso de drogas voltado para crianças e adolescentes, lançado nesta quarta-feira pelo Ministério da Justiça."
Reporter_Brasil_07_03,29.6,3258550,5230131,559,4,555,"O Cria vai capacitar professores para alertar, nas escolas, sobre o risco do uso de substâncias psicoativas como drogas e álcool."
Reporter_Brasil_07_03,38.56,3258554,5230132,510,2,508,"O estado do Ceará e municípios de São Paulo e do Piauí foram os primeiros a aderir ao programa."
Reporter_Brasil_07_03,45.24,4372940,5230138,976,4,972,"Mas a ideia é que até dois mil e vinte e seis, as cento e sessenta e três cidades prioritárias do PRONASCI, onde há maiores índices de violência, também participem da iniciativa."
Reporter_Brasil_07_03,56.32,3258556,5230133,1166,3,1163,"O desafio do governo não é apenas enfrentar a criminalidade com inteligência e força de segurança, mas também fortalecer a resiliência das comunidades vulneráveis diante do assédio do crime organizado."
Reporter_Brasil_07_03,72.36,3258558,5230134,826,1,825,"O governo também anunciou o sistema de alerta rápido sobre novas drogas."
Reporter_Brasil_07_03,77.52,4372942,5230139,419,1,418,"Que vai funcionar integrando os órgãos como a Receita e a Polícia Federal."
Reporter_Brasil_07_03,82.12,3258560,5230135,856,4,852,"Ele reúne dados das áreas de saúde e segurança pública para detectar novas substâncias psicoativas no país, principalmente as sintéticas."
Reporter_Brasil_07_03,91.4,3258567,5230136,216,1,215,"Em relação especificamente aos usuários de maconha, o ministro Ricardo Lewandowski aprovou a decisão do STF de descriminalizar o porte do entorpecente."
Reporter_Brasil_07_03,102.04,3258609,5230137,3052,1,3051,"Essa distinção que o Supremo Tribunal Federal está fazendo entre o usuário e o traficante poderá contribuir para que aqueles que são meros usuários não sejam presos e tenham um tratamento distinto, diferenciado."
Reporter_Brasil_07_03,116.88,4372944,5230140,31,5,26,"E isto, com certeza, servirá para aliviar a superlotação das prisões brasileiras."
Reporter_Brasil_07_07,0,3195147,5230174,458,1,457,"A periferia da zona norte de Porto Alegre foi uma das áreas mais afetadas pelas enchentes que a gente está mostrando já há bastante tempo."
Reporter_Brasil_07_07,6.24,3195149,5230175,329,4,325,"Nessas regiões, se concentram grande número de pessoas pobres e negras, muitas pertencentes a quilombos urbanos e terreiros também."
Reporter_Brasil_07_07,14.28,3195151,5230176,311,1,310,"Assim, a calamidade explicitou ainda mais as graves desigualdades sociais."
Reporter_Brasil_07_07,19.55,3195153,5230177,524,1,523,"O clube social Satélite Prontidão, uma das mais antigas sociedades de negros, está ajudando famílias severamente afetadas."
Reporter_Brasil_07_07,28.56,3195155,5230178,449,1,448,"Vamos ver na reportagem da TBE do Rio Grande do Sul, emissora da Rede Nacional de Comunicação Pública."
Reporter_Brasil_07_07,35.36,3195157,5230179,897,0,897,"O Satélite Prontidão, um dos clubes sociais negros mais antigos do Rio Grande do Sul com cento e vinte e dois anos, transformou-se em uma grande central de distribuição de donativos."
Reporter_Brasil_07_07,45.8,3195159,5230180,684,1,683,"O Satélite Prontidão fez uma parceria com outras organizações negras."
Reporter_Brasil_07_07,50.4,4380228,5230192,448,1,447,"Formando, assim, uma grande rede de solidariedade em prol dos povos de terreiros e dos quilombos urbanos."
Reporter_Brasil_07_07,57.4,3195161,5230181,609,2,607,"Ao todo, cento e sessenta e oito templos de matriz africana e setecentas famílias foram beneficiadas."
Reporter_Brasil_07_07,64.59,3195163,5230182,1445,2,1443,"De maio até agora, mais de vinte toneladas de alimentos foram entregues, beneficiando mais de dezesseis mil pessoas."
Reporter_Brasil_07_07,71.88,3195165,5230183,2300,2,2298,"Estamos aí, em um estado onde temos um número de vinte e três por cento, não é, de pessoas pretas e pardas e que muitos, não é, são adeptos das religiões de matriz africana."
Reporter_Brasil_07_07,85.04,3195167,5230184,501,2,499,"Entendemos, não é, que seria necessário ter um atendimento específico, não é."
Reporter_Brasil_07_07,89.3,4380230,5230193,1124,0,1124,"Já que muitos relatos de hostilidades, não é, de intolêrancia dentro de abrigos fez com que a gente, aí, acendesse um pouquinho, não é, esse farol para essa parte da população."
Reporter_Brasil_07_07,102.48,3195169,5230185,124,0,124,"É o caso do Ricardo."
Reporter_Brasil_07_07,104,3195171,5230186,745,1,744,"Ele morava no bairro Lami, na zona sul, e perdeu quase tudo com as cheias."
Reporter_Brasil_07_07,108.4,3195173,5230187,208,1,207,"Agora, está hospedado na casa da mãe."
Reporter_Brasil_07_07,110.64,3195175,5230188,84,0,84,"Como é que a gente trabalhar com um tanto de água?"
Reporter_Brasil_07_07,112.8,3195177,5230189,294,3,291,"Não tem como, tivemos que ser deslocados de lá, ir para um abrigo, não é, e as roupas da gente, sabe, a gente depende de vir uma ONG assim."
Reporter_Brasil_07_07,126,3195179,5230190,316,2,314,"O Satélite Prontidão, quando abre suas portas, ele faz exatamente esse serviço, de acolhimento a toda essa parte da população que realmente se viu em um momento de necessidade, de vulnerabilidade."
Reporter_Brasil_07_07,138.88,3195181,5230191,97,1,96,"Muitas pessoas ainda vão precisar dessa ajuda que a gente está conseguindo alcançar."
